111111111111111111111111111
1P0000000000000000C010C01C1
111111011011101111111011101
11111101C0C1100100000000001
111111010C010E000C001011111
1C111101111100110000101C001
101000001000101111111011101
100011100010000000001000001
111111111111111111111111111